1 1 1 1 1 1 1 1 1
1 S 0 0 1 W 0 0 1
1 0 0 0 1 1 0 0 1
1 0 0 0 L 0 0 B D
1 0 V 0 L 0 0 0 1
1 0 0 0 1 1 0 0 1
1 1 1 1 1 1 1 1 1